#######
#S    #
# # # #
# #   #
# #####
#    E#
#######