################
#              #
#       #      #
#       #      #
#    ## #      #
#  # #######   #
#S #      E#   #
#  #########   #
#              #
################